WWWWWWWWWWWWWWWWWWWW
WFFFFWWWFFFWWWFFFFFW
WFFFFFFWFFFWFFFFWWFW
W...................
....................
....................
....................
....................
....................
....................
....................
....................
....................
....................
....................
....................
....................
....................
....................
....................
